1111111111111111
10V0C00C00C0V0C1
1000000000000001
10011111111110C1
1P0011E00C100001
1000100000100001
1000100C0V100001
100C0000000000C1
1111111111111111
